0	= wall_solid_block/ground
1	= wall_ice_block/ground
2	= wall_ice_block/destructible
3	= wall_brick_block/indestructible
4	= wall_solid_block/indestructible
8	= NULL/AI/level(7)
9	= NULL/solo_position
10	= NULL/pvp_position

30 = palm_tree/environement/scale(3,3,3)/height(1)


31 31 31 31 31 31 31 31 31 31 31 31 31 31 31 31 31 31 31 31 31 31 31
4/1    4/1 4/1 4/1 4/1 4/1 4/1 4/1 4/1    4/1 4/1 4/1 4/1 4/1 4/1 4/1    4/1 4/1
4/1 8/10/0   0 2/0 2/0 2/0 2/0 2/0   0 8/10/0   0 2/0 2/0 2/0 2/0   0 8/10/0 4/1
4/1      0 3/0 2/0 3/0 2/0 3/0 2/0 3/0      0 3/0 2/0 3/0 2/0 3/0 2/0      0 4/1
4/1    2/0 2/0 2/0 2/0 2/0 2/0 2/0 2/0    2/0 2/0 2/0 2/0 2/0 2/0 2/0    2/0 4/1
4/1    2/0 2/0 2/0 3/0 2/0 3/0 2/0 3/0    2/0 3/0 2/0 3/0 2/0 3/0 2/0    2/0 4/1
4/1    2/0 2/0 2/0 2/0 2/0 2/0 2/0 2/0    2/0 2/0 2/0 2/0 2/0 2/0 2/0    2/0 4/1
4/1    2/0 3/0 2/0 3/0 2/0 3/0 2/0 3/0    2/0 3/0 2/0 3/0 2/0 3/0 2/0    2/0 4/1
4/1    2/0 2/0 2/0 2/0 2/0 2/0 2/0 2/0    2/0 2/0 2/0 2/0 2/0 2/0 2/0    2/0 4/1
4/1    2/0 3/0 2/0 3/0 2/0 3/0 2/0 3/0    2/0 3/0 2/0 3/0 2/0 3/0 2/0    2/0 4/1
4/1    2/0 2/0 2/0 2/0 2/0 2/0 2/0 2/0    2/0 2/0 2/0 2/0 2/0 2/0 2/0    2/0 4/1
4/1    2/0 3/0 2/0 3/0 2/0 3/0 2/0 3/0    2/0 3/0 2/0 3/0 2/0 3/0 2/0    2/0 4/1
4/1    2/0 2/0 2/0 2/0 2/0 2/0 2/0 2/0    2/0 2/0 2/0 2/0 2/0 2/0 2/0    2/0 4/1
4/1      0 3/0 2/0 3/0 2/0 3/0 2/0 3/0      0 3/0 2/0 3/0 2/0 3/0 2/0      0 4/1
4/1 9/10/0   0 2/0 2/0 2/0 2/0 2/0   0 8/10/0   0 2/0 2/0 2/0 2/0   0 8/10/0 4/1
4/1    4/1 4/1 4/1 4/1 4/1 4/1 4/1 4/1    4/1 4/1 4/1 4/1 4/1 4/1 4/1    4/1 4/1
31 31 31 31 31 31 31 31 31 31 31 31 31 31 31 31 31 31 31 31 31 31 31
