0	= wall_solid_block/ground
1	= wall_ice_block/ground
2	= wall_ice_block/destructible
3	= wall_brick_block/indestructible
4	= wall_solid_block/indestructible
8	= plant/AI
9	= NULL/solo_position
10	= NULL/pvp_position
11  = palm_tree/indestructible
12  = crate/indestructible
13	= NULL/NULL
14	= plant/environement/scale(0.8,0.8,0.8)/height(0.5)
15  = plant/indestructible
16	= crate/destructible/scale(2,2,2)/height(0.5)

13 11/1    4/1 4/1 4/1 4/1 4/1 4/1 4/1 4/1    4/1 4/1 4/1 4/1 4/1 4/1 4/1    4/1 11/1
13 4/1 8/10/0   0 0/0 0/0 0/0 0/0 0/0   0 8/10/0   0 0/0 0/0 0/0 0/0   0 8/10/0 4/1
13 4/1      0 0/0 0/0 0/0 0/0 0/0 0/0 0/0      0 0/0 0/0 0/0 0/0 0/0 0/0      0 12/1
14 4/1    0/0 0/0 2/0 0/0 0/0 0/0 2/0 0/0    0/0 0/0 2/0 0/0 0/0 0/0 0/0    0/0 4/1
15 4/1    0/0 0/0 0/0 0/0 0/0 0/0 0/0 0/0    0/0 0/0 0/0 0/0 0/0 0/0 0/0    0/0 12/1
14 4/1    0/0 14 0/0/14 0/0/14 0/0 0/0 0/0 0/0    0/0 0/0 0/0 0/0 0/0 0/0 0/0    0/0 12/1
15 4/1    0 0 0 0 0 0 0 0    0/0 0/0 0/0/14 0/0 0/0 0/0 0/0    0/0 4/1
14 4/1    0/0 0/0 0/0 0/0 0/0 0/0 0/0 0/0    0/0 0/0 0/0 0/0 0/0 0/0 0/0    0/0 4/1
13 4/1    0/0 0/0 0/0 0/0 0/0 2/0 2/0 0/0    0/0 0/0 0/0 0/0 0/0 0/0 0/0    0/0 4/1
13 4/1    0/0 0/0 0/0 0/0 0/16 2/0 2/0 0/0    0/0 0/0 0/0 2/0 0/0 0/0 0/0    0/0 12/1
13 4/1    0/0 0/0 2/0 0/0 0/0 0/0 0/0 0/0   0/0 0/0 0/0 0/0 0/0 0/0 0/0 0/0 0/0 0/0 0/0 0/0 0/0 0/0 0/0 0/0 0/0 0/0 0/0 0/0 0/0 0/0 0/0 0/0 0/0 0/0 0/0    0/0 12/1
13 4/1    0/0 0/0 0/0 0/0/14 0/0 0/0/14 0/0 0/0    0/0 0/0 0/0 0/0 0/0 0/0 0/0    0/0 12/1
13 4/1      0 0/0 0/0 0/0 0/0 0/0 0/0 0/0      0 0/0 0/0 0/0 0/0 0/0 0/0      0 4/1
13/11 4/1 9/10/0   0 0/0 0/0 0/0 0/0 0/0   0 8/10/0   0 0/0 0/0 0/0 0/0   0 8/10/0 11/1
13 4/1 8/10/0   0 0/0 0/0 0/0 0/0 0/0   0 8/10/0   0 0/0 0/0 0/0 0/0   0 8/10/0 4/1
13 4/1      0 0/0 0/0 0/0 0/0 0/0 0/0 0/0      0 0/0 0/0 0/0 0/0 0/0 0/0      0 12/1
14 4/1    0/0 0/0 2/0 0/0 0/0 0/0 2/0 0/0    0/0 0/0 2/0 0/0 0/0 0/0 0/0    0/0 4/1
15 4/1    0/0 0/0 0/0 0/0 0/0 0/0 0/0 0/0    0/0 0/0 0/0 0/0 0/0/14 0/0 0/0    0/0 12/1
14 4/1    0/0 14 0/0/14 0/0/14 0/0 0/0 0/0 0/0    0/0 0/0 0/0 0/0 0/0 0/0 0/0    0/0 12/1
15 4/1    0 0 0 0 0 0 0 0    0/0 0/0 0/0 0/0 0/0 0/0 0/0    0/0 4/1
14 4/1    0/0 0/0 0/0 0/0 0/0 0/0 0/0 0/0    0/0 0/0 0/0 0/0 0/0 0/0 0/0    0/0 4/1
13 4/1    0/0 0/0 0/0 0/0 0/0 2/0 2/0 0/0    0/0 0/0 0/0 0/0 0/0 0/0 0/0    0/0 4/1
13 4/1    0/0 0/0 0/0 0/0 0/0 2/0 2/0 0/0    0/0 0/0 0/0 2/0 0/0 0/0 0/0    0/0 12/1
13 4/1    0/0 0/0 2/0 0/0 0/0 0/0 0/0 0/0    0/0 0/0 0/0 0/0 0/0 0/0/14 0/0    0/0 12/1
13 4/1    0/0 0/0 0/0 0/0/14 0/0 0/0/14 0/0 0/0    0/0 0/0 0/0 0/0 0/0 0/0 0/0    0/0 12/1
13 4/1      0 0/0 0/0 0/0 0/0 0/0 0/0 0/0      0 0/0 0/0 0/0 0/0/14 0/0 0/0      0 4/1
13/11 4/1 9/10/0   0 0/0 0/0 0/0 0/0 0/0   0 8/10/0   0 0/0 0/0 0/0 0/0   0 8/10/0 11/1
13 11/1    4/1 4/1 4/1 4/1 4/1 4/1 4/1 4/1    4/1 4/1 4/1 4/1 4/1 4/1 4/1    4/1 4/1
