4 4 4 4 4 4 4 4 4 4 4 4 4 4 4
4 8 0 2 2 2 2 2 2 2 2 2 0 8 4
4 0 3 2 3 2 3 0 3 2 3 2 3 0 4
4 2 2 2 2 2 0 8 0 2 2 2 2 2 4
4 2 3 2 3 2 3 0 3 2 3 2 3 2 4
4 2 2 2 2 2 2 2 2 2 2 2 2 2 4
4 0 3 2 3 2 3 0 3 2 3 2 3 0 4
4 8 0 2 2 2 0 8 0 2 2 2 0 8 4
4 0 3 2 3 2 3 0 3 2 3 2 3 0 4
4 2 2 2 2 2 2 2 2 2 2 2 2 2 4
4 0 3 2 3 2 3 0 3 2 3 2 3 0 4
4 8 0 2 2 2 0 8 0 2 2 2 0 8 4
4 0 3 2 3 2 3 0 3 2 3 2 3 0 4
4 2 2 2 2 2 2 2 2 2 2 2 2 2 4
4 2 3 2 3 2 3 0 3 2 3 2 3 2 4
4 2 2 2 2 2 0 8 0 2 2 2 2 2 4
4 0 3 2 3 2 3 0 3 2 3 2 3 0 4
4 8 0 2 2 2 2 2 2 2 2 2 0 8 4
4 4 4 4 4 4 4 4 4 4 4 4 4 4 4
